NO textures/north.png
SO textures/south.png
WE textures/east.png
EA textures/west.png
    
C 255,255,255
F 80,80,80

1111
111
11N11
1111111
