NO textures/north.png
SO textures/south.png
WE textures/east.png
EA textures/west.png
    
C 255,255,255
F 80,80,80


0111111111110
1000011000001
1010010100001
1000000001011
1001101000001
1000000000001
1001000001001
1000001100101
111111
11111N111111
111111111111
