NO textures/north.png
SO textures/south.png
WE textures/east.png
EA textures/west.png
    
C 255,255,255
F 80,80,80

11111
10N01
11111
