NO textures/north.png
SO textures/south.png
WE textures/east.png
EA textures/west.png
    
C 255,255,255
F 80,80,80


1111111111111
1000010000001
1010000000101
1000000001001
1001101000001
1000000000001
1001000001001
1000001000101
1111111111N11
1111111111111
