NO textures/north.png
SO textures/south.png
WE textures/east.png
C 255,255,1
F 80,100,80
EA textures/west.png
    
C 255,55,255
F 80,80,80


1111111111110
1000011000001
1010010100001
1000000001011
1001101000001
100000N000001
1001000001001
1000001100101
1111101011111
1111111