NO textures/north.png
SO textures/south.png
WE textures/east.png
EA textures/west.png
    
F 10,0,40
C 100,200,100


1111111111
1000000001
1N00000001
1111111111
